; 8 8 8 8 8 8 8 8 8 8 8 8 8 8 8 8 8 8 8 8 : ; 8 8 8 8 8 8 8 8 8 8 8 8 8 8 8 8 8 8 8 8 8 8 8 : 
6 f f f f f f f f f f f f f f f f f fmf f 4 6 f f f f f f f f f f f o f f f f f f f f f f f 4 
6 f f_f f f f f f f f f f f f f fmf f f f 4 6 f f f f f fmf f f f f o f f f f f fmf f f f f 4 
, 2 2 2 2 2 2 2 2 2 2 2 2 3 f f f f f f f 4 6 f f f f f f f f f f f o f_f f f f f f f f f f 4 
                          6 f f f f f f f 7 9 f f f f f f o o o o o o o o o f f f f f f f f 4 
; 8 8 8 8 8 8 8 8 8 8 8 8 9 f f f f f f f f f f f f f f f f f f fcf fcf f f f f f f f f f f 4 
6 fmf f f f f f f f f f f f f f f f f f f f f fmf f f f f f f f f f f f f f f f f f f f f f 4 
6 f f f f f f f f f f f fOf f f f f f f f f f f f f f f f f f f f f f f f f f f f f f f f f 4 
6 f f f f f 1 3 f f f f f f f o f o f o f o f o f o f o f f f f fOf f f f f f f f f f f f f 4 
6 f f f f f 4 6 f f f f fmf f fcf fcf f f f f f f f f f f f f f f f f fmf f f f f f f f f f 4 
6 f f f f f 4 6 f f f f f f f f f f f f f f f f f f f f f f f f f f f f f f f f f f f f f f 4 
6 f f fOf f 4 6 f f f f f f f f f f f f f f f f f fmf f o f f f f f f f f f f f f f f f f f 4 
6 f f f f f 4 6 f f f f f f f f f f fOf f f f f f f f f o f f f f fmf f f f f f f fOf f f f 4 
6 f f f f f 4 6 f f fcf f f fcf f f f f f f f f f f f f o f f f f f f f f f f f f f f f f f 4 
6 f f f f f 4 , 2 2 2 2 2 2 2 2 2 2 2 2 2 2 2 2 2 2 2 2 3 f f f f o o o o o o o o f f f f o 4 
6 f f f f f 7 8 8 8 8 8 8 8 8 8 8 8 8 8 8 8 8 8 8 8 8 8 9 f f fmf o f f f f f f f f f f f f 4 
6 f f f f f f f f f f f f f f f f f f f f f f f f f f f f f f f f o f f f f f f f f f f f f 4 
6 f f f f f f f fOf f f f f f f f f f f f fOf f f f f f f fOf f fmo f f f f_f f f f f f f f 4 
, 2 2 2 2 2 2 2 2 2 2 2 2 2 2 2 2 2 2 2 2 2 2 2 2 2 2 2 2 2 2 2 2 2 2 2 2 2 2 2 2 2 2 2 2 2 . 